11111111111111111111111
11111111111111111111111
11111111000111111111111
111111100000111111111
111111000000011111111
11111110000000111111111
11111111000000011111111
11111110000000011111111
111111000000011111111
111111100000111111111
111111110001111111111111
111111111X11111111111111
11111111A111111111111111