1111111111
1111111111
1111111111
1111111111
11111111111
111001111111
111111001111
111001001111
111001001111
11111111111
1111111111
1111100011
1111100011
1111111111
11111111111A