111111111111111111111111
111111110001111111111111
111111100000111111111111
111111000000011111111111
111111100000001111111111
111111110000000111111111
111111100000001111111111
111111000000011111111111
111111100000111111111111
111111110001111111111111
111111111111111111111111
1111111111A1111111111111