1111111111
1111111111
1111111111
1111111111
11111111111
111001111111
111111011111
111001000011
111001010111
11111111111
1111111111
1111100011
1111100011
1111A11111
111111111111